0000000000
0100000000
0100000000
0111111111
0000000000
1111111110
0000100000
0000100000
0000111101
0000400000